#####
#...#
#.g.#
#...#
#...#
#.p.#
#...#
#####
1
1
0
1
