########
#c....c#
#......#
#...g..#
#......#
#......#
#p.e..c#
########
1
6
0
4
3
