########
#c....c#
#..eee.#
#...g..#
#c.....#
#.ee...#
#pee..c#
########
1
6
0
4
3
