#####
#.g.#
#e#.#
#.p.#
#####
1
4
0
0
