#####
#c.c#
#...#
#.e.#
#.e.#
#...#
#pg.#
#####
1
5
0
2
2
