..........
..........
.....p....
..........
..........
..........
..........
...#...#..
...#ccc#..
...#ceg#..
1
-1
-1
-1
1
0
