..........
.....1....
..#.....#.
..#eg...#.
..#...c.#.
..#.c...#.
..#....c#.
..........
....p.....
..........
1
-1
-1
-1
1
0
