##########
#c.p...c.#
######c#c#
#..c...c.#
#c##..####
#..c..####
#####c####
#.c.e.####
#ge.c.####
##########
1
-1
-1
-1
1
0
2
0
