##############
#ccc.c...cccg#
#cpc.c...c...#
#ccc.c...c...#
#c...c...c.cc#
#c...c...c..c#
#c...ccc.cccc#
##############
1
-1
-1
-1
